##############################
#       #    #         #    #
# ####  #### # ####### # ## #
# #  #       #       # #  # #
# #  ####### ####### # #### #
# #      #   #     # #      #
# ###### # ### ### # ###### #
# #    # #   #   # #      B#
# # ## # ### # ### ####### #
# #  # #   # # #         # #
# ## # ### # # ####### # # #
# #  #   # # # #       # # #
# ###### # # # # ####### # #
#      #   # # #   #     # #
#### # ###### # ### # ### #
#A   #        #     #     #
##############################
