########################################
#A      #       #       #        #    #
# ####### ##### # ##### # ###### # ## #
#       # #   #   #   #   #    # #  # #
####### # # # ##### # ##### ## # #### #
#       # # #     # #   #    # #      #
# ####### # ##### # ### #### # ###### #
# #     # # #   #   # # #  # #      B #
# # ### # # # # ##### # ## # ####### #
#   #   #   # #   #   #    #        # #
##### ##### ### # # ####### ######## #
#       #       # #       # #        #
# ####### ##### # ####### # # ########
#       #   #   #     #   #          #
# ##### ### # ### ### # ####### #####
#     #     #     #   #            #
########################################
